11111111111111111111
10000000000000000001
10111111111111111111
10100000000000100001
10101111111110101101
10101000000110101101
10101011110110101101
10101000010100001001
10101111110111101001
10100000110000001001
10111110111111111001
1000000000000011000E
1000000000000001000E
11111000111101111111
11111111111111111111