111111111111111111
100000000000000001
101111110011111101
101000010010000001
101011010010111101
101000010000000E01
111111111111111111
