111111111111111111
100000000000000001
100111111110111101
101000000010000E01
101011111011110101
101000001000000101
111111111111111111
