11111111111111111111
10011000000000000001
10011111111100111011
10010000000000001101
10010111111100101011
10010100000000001001
1001010111111111100E
1001010001000010100E
10010111010110001001
10010111000100001001
10010011111111100011
10000000000100000011
10000000000111001011
11010011111111111111
11111111111111111111
